00000000000000000000
0     2            0
0     2            0
0               3330
0                  0
0                  0
0                  0
0                  0
0                  0
0                  0
0                  0
0                  0
0                  0
0             111110
0                  0
0          1       0
0          1       0
0          1       0
0          1       0
00000000000000000000