00000000000000000000
0     2            0
0     2            0
0               3330
0                  0
0                  0
0              33330
0              3   0
0              3   0
0              3   0
0                  0
02222222           0
0   3              0
0   3         111110
0   3              0
0          1       0
0          1       0
0          1       0
0          1       0
00000000000000000000