00000000000000000000
0   01            10
0   0    000000    0
01 111  111  111   0
0                  0
0                  0
011111             0
0                  0
0                  0
0                  0
0                  0
0                  0
0                  0
0                  0
0                  0
0                  0
0                  0
0                  0
0                  0
00000000000000000000